1111111111111111111111111111111
1CCCCCCCCCCCCCCCCCCCCCCCCCCCCC1
1C111111111111111111111111111C1
1C1CCCCCCCCCCCCCCCCCCCCCCCCCCC1
1C1C111111111111111111111111111
1C1CCCCCCCCCCCCCCCCCCCCCCCCCC11
1C11111111111111111111111111C11
1C1ECCCCCCCCCCCCCCCCCCCCCCCCC11
1C11111111111111111111111111111
1CCCCCCCCCCCCCCCCCCCCCCCCCCC0P1
1111111111111111111111111111111